wwwwwwwwwwwwwwwwwwwwwwwwwwww
ww..................cc.cc..w
w.w.w.wcw..............w..cw
w....cc....................w
wcw.wcw.w.wcwc.............w
wcc........................w
w.w.w.w.w.wcw..............w
w...c.....c................w
w.wcw.w.wcwcw..............w
w.c......cc.cc.............w
w.w.wcw.w.w.w..............w
w..c.c.c.c.c...............w
wwwwwwwwwwwwwwwwwwwwwwwwwwww
