wwwwwwwwwwwwwww
w...cw..c..c..w
w.wcw.wcw.w.wcw
w....cc....c..w
wcw.wcw.w.wcwcw
wcc...c.......w
w.w.w.wcw.wcw.w
wc..c.....c...w
wcwcw.w.wcwcw.w
w.c......cc.ccw
w.w.wcw.w.w.w.w
w..c.c.c.c.c.ww
wwwwwwwwwwwwwww
